11111111111111111111111111111111
1000000000P001000111101000010001
10000000000000000000000000100001
100000C00011100001100111110000111
1000000000001000110000000000001
10010000E0001000010010000000000111
100100000000100000001000000001
11111111111111111111111111111111