11111111111111111111111111111111
100000000000P0001111010000100001
10000000000000000000000000100001
10000C00001110000110011111000011
10000000000010001100000000000001
100100000E0010000100100000000001
10010000000010000000100000000001
11111111111111111111111111111111