11111111111111111111111111111111
1000000000P001000111101000010001
10000000000000000000000000100001
100000C0001110000110011111000011
10000000000010001100000000000001
10010000E000100001001000000000011
1001000000001000000010000000001
11111111111111111111111111111111