111111111111111111111111111111111111111
1000C0000000P00011110100001000000000001
10000000000000000000000C001000000000001
10000C00001110000110011111000010000C001
10000000000010001100000000000C000000001
100100000E001000010010000C00000000C0011
1001000000001000000010000000000000000C1
111111111111111111111111111111111111111