111111111111111111111111111111111111111111111111111111111111111111111111111111111111111111111111
10000000000001001111010000100CE11000000000000000000000000000000110000000000000000000000000000001
100000000000000000000000000000011000000000000000000000000000000110000000000000000000000000000001
10000C000011100001100100010000111000000000000000000000000000000110000000000000000000000000000001
1000000000001000110000000000C0011000000000000000000000000000000110000000000000000000000000000001
100100000000100001001000000000011000000000000000000000000000000110000000000000000000000000000001
100100000000100000001000000000011000000000000000000000000000000110000000000000000000000000000001
100100000C00100000001000000C00011000000000000000000000000000000110000000000000000000000000000001
1001000C0000100000001000000000011000000000000000000000000000000110000000000000000000000000000001
100100000000100000001000000000011000000000000000000000000000000110000000000000000000000000000001
100100C00000100000001000000000011000000000000000000000000000000110000000000000000000000000000001
1001000000001000C000100000C000011000000000000000000000000000000110000000000000000000000000000001
1001000000001000C000100000C000011000000000000000000000000000000110000000000000000000000000000001
1001000000001000C000100000C000011000000000000000000000000000000110000000000000000000000000000001
1001000000001000C000100000C000011000000000000000000000000000000110000000000000000000000000000001
1001000000001000C000100000C000011000000000000000000000000000000110000000000000000000000000000001
1001000000001000C000100000C000011000000000000000000000000000000110000000000000000000000000000001
1001000000001000C000100000C000011000000000000000000000000000000110000000000000000000000000000001
1001000000001000C000100000C000011000000000000000000000000000000110000000000000000000000000000001
1001000000001000C000100000C000011000000000000000000000000000000110000000000000000000000000000001
1001000000001000C000100000C000011000000000000000000000000000000110000000000000000000000000000001
1001000000001000C000100000C000011000000000000000000000000000000110000000000000000000000000000001
1001000000001000C000100000C000011000000000000000000000000000000110000000000000000000000000000001
1001000000001000C000100000C000011000000000000000000000000000000110000000000000000000000000000001
1001000000001000C000100000C000011000000000000000000000000000000110000000000000000000000000000001
1001000000001000C000100000C000011000000000000000000000000000000110000000000000000000000000000001
1P0100000000100000001000000000011000000000000000000000000000000110000000000000000000000000000001
111111111111111111111111111111111111111111111111111111111111111111111111111111111111111111111111