11111111111111111111111111111111
10000000000001001111010000100CE1
10000000000000000000000000000001
10000C00001110000110010001000011
1000000000001000110000000000C001
10010000000010000100100000000001
10010000000010000000100000000001
100100000C00100000001000000C0001
1001000C000010000000100000000001
10010000000010000000100000000001
100100C0000010000000100000000001
1001000000001000C000100000C00001
1P010000000010000000100000000001
11111111111111111111111111111111