NO ./img/NN.xpm
SO ./img/SS.xpm
WE ./img/WW.xpm
EA ./img/EE.xpm

C 153,219,233
F 220,   191, 151



                1111111111111111111111111
                1111110111111111111111111
                1111111111111111111111111
                1001000000000000000000001
        111111111011000001110000000000001
        1000000000110000011101111111111111
        11110111111111011100000010001
        11110111111111011101010010001
        11000000110101011100001010001
        11111111111111111111111111111

        1111111111111111111111111111
        10000000000000001100000010001
        10000000000000001101010010001
        1100000011010101111101111000111        1111
        11110111 1110101 101111010001          10W1
        11111111 1111111 111111111111          1111


