NO ./img/NN.xpm
SO ./img/SS.xpm
WE ./img/WW.xpm
EA ./img/EE.xpm    
				
				
F 3,0,28
C 21,1,80


        1111111111111111111111111
        1000000000110000000000001
        1011000001110000000000001
        1001000000000000000000001
111111111011000001110000000000001
100000000011000001110111111111111
11110111111111011100000010001
111101111111110111010100100011111111111111111111
1100000011010101110000001000000000010101010101101
101010101111000000000000000S000000000000000000011111
10000000000000001100000000000000000101010101011101101
1000000000000000110101101000000000000000000000011  1
1100000111010101111101111000000000100000001000001
1110111 1110101 101111010000000000010000001111001
11111111 1111111 111111111111111111 111111   1111
