11111111111111111111111111111111
10000C00000000000000010000100001
10C000000000000P0000000000100001
1000000C001110000000011111000001
1000000C000010000000000000000001
1001000C000010000000000000C00001
10E1000C000010000000C00000000001
11111111111111111111111111111111