11111111111111111111111111111111
10000C00000000000000000000000001
10C00000000000000000000000000001
1000000C000000000000000000000001
1000000C00P000000000000000000001
1000000C000000000000000000000001
10E0000C000000000000000000000001
11111111111111111111111111111111